xxxxxxxxxxxxxxxx
x  s       s   x
x              x
x              x
x              x
x              x
x   svvvvvs    x
x   ss   ss    x
x   sv   vs    x
x   sv f vs    x
x   svvvvvs    x
xxxxxxxxxxxxxxxx
